11111111111
1P000001001
1000C001001
110010C00E1
11111111111