11111111111111111111
1P000001C000000C0001
1000C001000100001001
110010C0001000001001
11011111000001111001
1C010C00000001E00001
11111111111111111111