1111111111
1000000001
1001P1E001
100C1C0001
1111111111