111111111111111111111
100000000010000000001
1000000001P1000000001
100000001C0C100000001
10000001C000C10000001
1000001C00000C1000001
100001C0000000C100001
10001CCCCCCCCCCC10001
100000000000000000001
1000000000E0000000001
111111111111111111111